NO            ./textures/AnyConv.com__BRICK_4A.xpm
SO       ./textures/AnyConv.com__SAND_1A.xpm
WE                     ./textures/AnyConv.com__STEEL_1A.xpm
F                253,254,255
EA                        ./textures/AnyConv.com__TECH_4E.xpm

C             100,100,100
11111
11N11
11111