NO            ./textures/N.xpm
WE                     ./textures/test.xpm
EA                        ./textures/E.xpm
SO       ./textures/S.xpm

F                253,254,255
C             100,100,100
 11111111
 10000001
1000000001
1000000001
1000000001
1000000001
1000S00001
1000000001
1000000001
1000000001
1000000001
1000000001
1111111111