NO            ./textures/AnyConv.com__BRICK_4A.xpm
SO       ./textures/AnyConv.com__SAND_1A.xpm
WE                     ./textures/AnyConv.com__STEEL_1A.xpm
F                255,0,0
EA                        ./textures/AnyConv.com__TECH_4E.xpm

C             0,0,255

 11111111111111111111111111111111111111111111
1N0000001000000000110000000000001000010000001
100000001110000011100000000000001000010000001
100000001001000000000000000000001110110000001
111101111011000001110000000000000000000000001
100000000011000001110000000011111111111101111
1111011111111101110000001000100000000000000011111111111111111111111111
1111011111111101110101001000100000000000000000000000000000000000000001
1100000011010101110000001000100000000000000011111111111111111111111101
100000000000000011000000000010000000000000001                  1000101
100000000000000011010100100010000000000000001                  1000001
110000011101010111110111100011101100000000001                  1000101
1111011101010101 1011110100010000100000000001                  1111101
1111111111111111 1111111111111111111111111111                  1000101
                                                               1000001
                                                               1111111
