NO ./textures/AnyConv.com__BRICK_4A.xpm
SO ./textures/AnyConv.com__SAND_1A.xpm
WE ./textures/AnyConv.com__STEEL_1A.xpm
EA ./textures/AnyConv.com__TECH_4E.xpm

F                1,2,3
C             253,254,255

        1111111111111111111111111    11111111
        1000000000110000000000001    10000001
        1110000011100000000000001    10000001
        10010000000000000000S0001111110000001
111111111011000001110000000000000000000000001
100000000011000001110000000011111111111111111
11110111111111011100000010001
11110111111111011101010010001
11000000110101011100000010001
10000000000000001100000000001
10000000000000001101010010001
1100000111010101111101111000111
11110111 1110101 101111010001
11111111 1111111 111111111111
